##############################
#     ############    ########
## ## #     ###### ###########
## ## # ### ###### ###########
## ##   ### ####      ########
## ######## #### #### ########
#  ######## #### #### ########
###########      #### ########
#######     #### ####       ##
####### ######## #############
####### ########   ###     ###
##    #       #### ### ### ###
## #### ##### #### ### ### ###
## #### ##### #### ### ###   #
## #### #####    ##### ##### #
## #### ########       ####  #
##      ######### ########## #
##########        ########## #
###        ######    ####### #
############################=#