##############################
#                            #
############################ #
#          #                 #
# ########### ################
#                            #
# ########################## #
#      #                     #
# ############################
#                            #
################# ########## #
#                   #        #
# ###### #####################
#    #                       #
#################### ####### #
#         #            #     #
############ ### #############
#            #               #
############################ #
############################=#