##############################
#                            #
############################ #
#                            #
# ############################
#                            #
############################ #
#                            #
# ############################
#                            #
############################ #
#                            #
# ############################
#                            #
############################ #
#                            #
# ############################
#                            #
############################ #
############################=#